/kb/dev_container/modules/nextgen/diagrams/typespecs/specs_typecomp/amethst.spec	AMETHSTService
/kb/dev_container/modules/nextgen/diagrams/typespecs/specs_typecomp/AskKB.spec	AskKB
/kb/dev_container/modules/nextgen/diagrams/typespecs/specs_typecomp/assembly_input_handle.spec	AssemblyInputHandle
/kb/dev_container/modules/nextgen/diagrams/typespecs/specs_typecomp/auth_integration.spec	AuthIntegration
/kb/dev_container/modules/nextgen/diagrams/typespecs/specs_typecomp/Biochem.spec	KBaseBiochem
/kb/dev_container/modules/nextgen/diagrams/typespecs/specs_typecomp/Cmonkey.spec	Cmonkey
/kb/dev_container/modules/nextgen/diagrams/typespecs/specs_typecomp/CoExpression.spec	CoExpression
/kb/dev_container/modules/nextgen/diagrams/typespecs/specs_typecomp/CompressionBasedDistance.spec	CompressionBasedDistance
/kb/dev_container/modules/nextgen/diagrams/typespecs/specs_typecomp/ERDB_Service.spec	ERDB_Service
/kb/dev_container/modules/nextgen/diagrams/typespecs/specs_typecomp/Expression.spec	KBaseExpression
/kb/dev_container/modules/nextgen/diagrams/typespecs/specs_typecomp/expressionServices.spec	ExpressionServices
/kb/dev_container/modules/nextgen/diagrams/typespecs/specs_typecomp/FBAModel.spec	KBaseFBA
/kb/dev_container/modules/nextgen/diagrams/typespecs/specs_typecomp/Genome.spec	KBaseGenomes
/kb/dev_container/modules/nextgen/diagrams/typespecs/specs_typecomp/GenomeAnnotation.spec	GenomeAnnotation
/kb/dev_container/modules/nextgen/diagrams/typespecs/specs_typecomp/GenomeComparison.spec	GenomeComparison
/kb/dev_container/modules/nextgen/diagrams/typespecs/specs_typecomp/GWAS.spec	GWAS
/kb/dev_container/modules/nextgen/diagrams/typespecs/specs_typecomp/handle_mngr.spec	HandleMngr
/kb/dev_container/modules/nextgen/diagrams/typespecs/specs_typecomp/handle_service.spec	AbstractHandle
/kb/dev_container/modules/nextgen/diagrams/typespecs/specs_typecomp/id_map.spec	IdMap
/kb/dev_container/modules/nextgen/diagrams/typespecs/specs_typecomp/IDServer-API.spec	IDServerAPI
/kb/dev_container/modules/nextgen/diagrams/typespecs/specs_typecomp/Inferelator.spec	Inferelator
/kb/dev_container/modules/nextgen/diagrams/typespecs/specs_typecomp/InvocationService.spec	InvocationService
/kb/dev_container/modules/nextgen/diagrams/typespecs/specs_typecomp/KBaseAssembly.spec	KBaseAssembly
/kb/dev_container/modules/nextgen/diagrams/typespecs/specs_typecomp/KBaseDataImport.spec	KBaseDataImport
/kb/dev_container/modules/nextgen/diagrams/typespecs/specs_typecomp/KBaseExpression.spec	KBaseExpression
/kb/dev_container/modules/nextgen/diagrams/typespecs/specs_typecomp/KBaseGeneFamilies.spec	KBaseGeneFamilies
/kb/dev_container/modules/nextgen/diagrams/typespecs/specs_typecomp/KBaseGenomes.spec	KBaseGenomes
/kb/dev_container/modules/nextgen/diagrams/typespecs/specs_typecomp/KBaseGwasData-v01.spec	KBaseGwasData
/kb/dev_container/modules/nextgen/diagrams/typespecs/specs_typecomp/KBaseGwasData-v02.spec	KBaseGwasData
/kb/dev_container/modules/nextgen/diagrams/typespecs/specs_typecomp/KBaseGwasData-v03.spec	KBaseGwasData
/kb/dev_container/modules/nextgen/diagrams/typespecs/specs_typecomp/KBaseGwasData.spec	KBaseGwasData
/kb/dev_container/modules/nextgen/diagrams/typespecs/specs_typecomp/KBaseNetworks.spec	KBaseNetworks
/kb/dev_container/modules/nextgen/diagrams/typespecs/specs_typecomp/KBaseProteinStructure.spec	KBaseProteinStructure
/kb/dev_container/modules/nextgen/diagrams/typespecs/specs_typecomp/KBaseSearch.spec	KBaseSearch
/kb/dev_container/modules/nextgen/diagrams/typespecs/specs_typecomp/KBaseTrees.spec	KBaseTrees
/kb/dev_container/modules/nextgen/diagrams/typespecs/specs_typecomp/KmerAnnotationByFigfam.spec	KmerAnnotationByFigfam
/kb/dev_container/modules/nextgen/diagrams/typespecs/specs_typecomp/KmerEval.spec	KmerEval
/kb/dev_container/modules/nextgen/diagrams/typespecs/specs_typecomp/MAK.spec	MAK
/kb/dev_container/modules/nextgen/diagrams/typespecs/specs_typecomp/MEME.spec	MEME
/kb/dev_container/modules/nextgen/diagrams/typespecs/specs_typecomp/MOTranslationService.spec	MOTranslation
/kb/dev_container/modules/nextgen/diagrams/typespecs/specs_typecomp/narrative_object.spec	KBaseNarrative
/kb/dev_container/modules/nextgen/diagrams/typespecs/specs_typecomp/NarrativeJobService.spec	NarrativeJobService
/kb/dev_container/modules/nextgen/diagrams/typespecs/specs_typecomp/networks.spec	KBaseNetworks
/kb/dev_container/modules/nextgen/diagrams/typespecs/specs_typecomp/NJSWrapper.spec	NarrativeJobService
/kb/dev_container/modules/nextgen/diagrams/typespecs/specs_typecomp/Ontologies.spec	Ontology
/kb/dev_container/modules/nextgen/diagrams/typespecs/specs_typecomp/Ontology.spec	KBaseOntology
/kb/dev_container/modules/nextgen/diagrams/typespecs/specs_typecomp/Phenotypes.spec	KBasePhenotypes
/kb/dev_container/modules/nextgen/diagrams/typespecs/specs_typecomp/ProbabilisticAnnotation.spec	ProbabilisticAnnotation
/kb/dev_container/modules/nextgen/diagrams/typespecs/specs_typecomp/PROM.spec	PROM
/kb/dev_container/modules/nextgen/diagrams/typespecs/specs_typecomp/ProteinInfoService.spec	ProteinInfo
/kb/dev_container/modules/nextgen/diagrams/typespecs/specs_typecomp/RDPTools.spec	RDPTools
/kb/dev_container/modules/nextgen/diagrams/typespecs/specs_typecomp/Regulation.spec	KBaseRegulation
/kb/dev_container/modules/nextgen/diagrams/typespecs/specs_typecomp/ServiceRegistry.spec	ServiceRegistry
/kb/dev_container/modules/nextgen/diagrams/typespecs/specs_typecomp/sim.spec	Sim
/kb/dev_container/modules/nextgen/diagrams/typespecs/specs_typecomp/taxonomy_translation.spec	TaxonomyTranslation
/kb/dev_container/modules/nextgen/diagrams/typespecs/specs_typecomp/Transform.spec	Transform
/kb/dev_container/modules/nextgen/diagrams/typespecs/specs_typecomp/Tree.spec	Tree
/kb/dev_container/modules/nextgen/diagrams/typespecs/specs_typecomp/upstart_integration.spec	UpstartIntegration
/kb/dev_container/modules/nextgen/diagrams/typespecs/specs_typecomp/userandjobstate.spec	UserAndJobState
/kb/dev_container/modules/nextgen/diagrams/typespecs/specs_typecomp/UserProfile.spec	UserProfile
/kb/dev_container/modules/nextgen/diagrams/typespecs/specs_typecomp/workspace.spec	Workspace
/kb/dev_container/modules/nextgen/diagrams/typespecs/specs_workspace/BAMBI.spec	BAMBI
/kb/dev_container/modules/nextgen/diagrams/typespecs/specs_workspace/Cmonkey.spec	Cmonkey
/kb/dev_container/modules/nextgen/diagrams/typespecs/specs_workspace/Communities.spec	Communities
/kb/dev_container/modules/nextgen/diagrams/typespecs/specs_workspace/Empty.spec	Empty
/kb/dev_container/modules/nextgen/diagrams/typespecs/specs_workspace/GenomeComparison.spec	GenomeComparison
/kb/dev_container/modules/nextgen/diagrams/typespecs/specs_workspace/Inferelator.spec	Inferelator
/kb/dev_container/modules/nextgen/diagrams/typespecs/specs_workspace/KBaseAssembly.spec	KBaseAssembly
/kb/dev_container/modules/nextgen/diagrams/typespecs/specs_workspace/KBaseBiochem.spec	KBaseBiochem
/kb/dev_container/modules/nextgen/diagrams/typespecs/specs_workspace/KBaseCommon.spec	KBaseCommon
/kb/dev_container/modules/nextgen/diagrams/typespecs/specs_workspace/KBaseCommunities.spec	KBaseCommunities
/kb/dev_container/modules/nextgen/diagrams/typespecs/specs_workspace/KBaseExpression.spec	KBaseExpression
/kb/dev_container/modules/nextgen/diagrams/typespecs/specs_workspace/KBaseFBA.spec	KBaseFBA
/kb/dev_container/modules/nextgen/diagrams/typespecs/specs_workspace/KBaseFile.spec	KBaseFile
/kb/dev_container/modules/nextgen/diagrams/typespecs/specs_workspace/KBaseGeneFamilies.spec	KBaseGeneFamilies
/kb/dev_container/modules/nextgen/diagrams/typespecs/specs_workspace/KBaseGenomes.spec	KBaseGenomes
/kb/dev_container/modules/nextgen/diagrams/typespecs/specs_workspace/KBaseGwasData.spec	KBaseGwasData
/kb/dev_container/modules/nextgen/diagrams/typespecs/specs_workspace/KBaseNarrative.spec	KBaseNarrative
/kb/dev_container/modules/nextgen/diagrams/typespecs/specs_workspace/KBaseNetworks.spec	KBaseNetworks
/kb/dev_container/modules/nextgen/diagrams/typespecs/specs_workspace/KBaseOntology.spec	KBaseOntology
/kb/dev_container/modules/nextgen/diagrams/typespecs/specs_workspace/KBasePhenotypes.spec	KBasePhenotypes
/kb/dev_container/modules/nextgen/diagrams/typespecs/specs_workspace/KBasePPI.spec	KBasePPI
/kb/dev_container/modules/nextgen/diagrams/typespecs/specs_workspace/KBaseRegulation.spec	KBaseRegulation
/kb/dev_container/modules/nextgen/diagrams/typespecs/specs_workspace/KBaseSearch.spec	KBaseSearch
/kb/dev_container/modules/nextgen/diagrams/typespecs/specs_workspace/KBaseSequences.spec	KBaseSequences
/kb/dev_container/modules/nextgen/diagrams/typespecs/specs_workspace/KBaseTrees.spec	KBaseTrees
/kb/dev_container/modules/nextgen/diagrams/typespecs/specs_workspace/MAK.spec	MAK
/kb/dev_container/modules/nextgen/diagrams/typespecs/specs_workspace/MEME.spec	MEME
/kb/dev_container/modules/nextgen/diagrams/typespecs/specs_workspace/ProbabilisticAnnotation.spec	ProbabilisticAnnotation
